................................
................................
................................
................................
................................
................................
................................
................................
................................
................................
................................
................................
................................
................................
................................
...P......F...........E......C..
WWWWWWWWWWWWWWWWWWWWWWWWWWWWWWWW