................................
................................
................................
................................
................................
................................
................................
................................
................................
................................
................................
................................
................................
................................
................................
...P......c....f....e...........
WWWWWWWWWWWWWWWWWWWWWWWWWWWWWWWW